10.1 
1...1.....
..1.1.....
..........
..........
.........1
..1.......
....111.11
....1.1.1.
....1.....
...1......