30()!
))()((((()(()))((()())((((()((
((((()(())(((()((((()))()(((((
((()((((((())())((()((()(())((
())())(((((((()()((())(((()(((
)(()((())())())))()((()(((((((
()()((()((((((()()())()((()()(
((((())((()())))))()(((((()(()
)())()(()(((()(()))(((((((((((
())((((())(()(((()()(()(())())
())(()((((())()()()((((((())()
(((((()(((((())())(()()()(((((
(()(((((()((((()(()(()(())))()
(((()(((((()))()()()((((())(((
)((()()((((((()((((((()((()())
(((((((((((()()(())(((((()()()
)(((((((((()(())((())))(((((()
((((((()(()()))((())(((()))(((
)(())))(()(())()((((()((())(((
()()(())((((((())(())()((())()
))(()()(())(((()))(()(()((()))
)))(()(()((()(((()())((((()())
()))(())))(((()())(((((()()))(
(())(())(())((()())()(()((((((
(()((((((((()((((((((()(())(((
)()((()(()(()(()())())((((()()
(())(()()()(((((()(()((((()(()
)(((((((()(()(((((())())(()()(
()(()())))(()))(((()(())(()(((
((((((()))(()(((())((((())((((
)(((()()(()())())()()((()()()(