30-+#
------+---------+---++---+-+-+
-+-++++-++--++---+--++--++-+--
++----++---+-++-----------++-+
-++--+---+-------+--+---+-----
+----+++----+-+------+-----+-+
--+--+--+++----++++-+++---+---
+-+-+--++-+----+----+++-+----+
---++-++---------+-+-+-++-+---
----+--+-+-+------+----+------
----+--+++--++--+---++---+-++-
--+--+------+-+----+--+-+-----
---+--+----+-+---+-+++-------+
+-------+----+---++---+--+-+-+
---+---+--++++-+-+-+-----++-++
--+------+-+-+--+--++-+-----+-
-+----++--+-+--+---+-+-+------
+----+------+-+-+--+--------+-
------+--+---+-----++-----+-+-
-++-+-+-+--+-++----+----------
-+-+-----+-+-++-+++----+------
+-------+-++--------++----+---
+-+-+--+--+--+-+--+++--+++----
++-+-+-++------++---+-+-+-----
+-+-+------+------+-----+-+---
--++--+--++--+---+-+-+--+--+--
--+--+---+-+------+++--------+
-++--+-++--+----+++-+-+------+
+-+-+-------------+------+---+
--+++-+-+++------+----+------+
----++----+-----++---+--+-+---